static const bellSlashIconSvg = 'assets/svg/bell slash icon.svg';
static const bellIconGraySvg = 'assets/svg/bell-icon-gray.svg';
static const bellIconSvg = 'assets/svg/bell-icon.svg';
static const chartIconSvg = 'assets/svg/chart-icon.svg';
static const checkboxSvg = 'assets/svg/checkbox.svg';
static const chipIconBlueSvg = 'assets/svg/chip icon blue.svg';
static const chipIconWhiteRemovebgPreviewSvg = 'assets/svg/chip_icon_white-removebg-preview.svg';
static const dashboardIconRemovebgPreviewSvg = 'assets/svg/dashboard_icon-removebg-preview.svg';
static const dropDownArrowIconRemovebgPreviewSvg = 'assets/svg/drop_down_arrow_icon-removebg-preview.svg';
static const editIconRemovebgPreviewSvg = 'assets/svg/edit_icon-removebg-preview.svg';
static const electricityCountIconRemovebgPreview_1Svg = 'assets/svg/electricity_count_icon-removebg-preview-1.svg';
static const historyIconSvg = 'assets/svg/history-icon.svg';
static const lightningBoltIconRemovebgPreview_2Svg = 'assets/svg/lightning_bolt_icon-removebg-preview-2.svg';
static const listIconRemovebgPreviewSvg = 'assets/svg/list_icon-removebg-preview.svg';
static const mapIconRemovebgPreviewSvg = 'assets/svg/map_icon-removebg-preview.svg';
static const moreHorizontalIconSvg = 'assets/svg/more-horizontal-icon.svg';
static const moreVerticalIconSvg = 'assets/svg/more-vertical-icon.svg';
static const plusIconRemovebgPreview_1Svg = 'assets/svg/plus_icon-removebg-preview_1.svg';
static const profileIconRemovebgPreview_1Svg = 'assets/svg/profile_icon-removebg-preview_1.svg';
static const readingsIconSvg = 'assets/svg/readings-icon.svg';
static const refreshIconSvg = 'assets/svg/refresh-icon.svg';
static const reportIconSvg = 'assets/svg/report-icon.svg';
static const searchIconSvg = 'assets/svg/search-icon.svg';
static const settingSvg = 'assets/svg/setting.svg';
static const settingsIconSvg = 'assets/svg/settings-icon.svg';
static const thingsIconSvg = 'assets/svg/things-icon.svg';
static const tickIconSvg = 'assets/svg/tick-icon.svg';
static const tickWithoutCircleIconSvg = 'assets/svg/tick-without-circle-icon.svg';
static const timerIconSvg = 'assets/svg/timer-icon.svg';
static const userIconSvg = 'assets/svg/user-icon.svg';
static const usersIconSvg = 'assets/svg/users-icon.svg';
static const viewIconRemovebgPreviewSvg = 'assets/svg/view_icon-removebg-preview.svg';
static const virtualDevicesIconRemovebgPreviewSvg = 'assets/svg/virtual_devices_icon-removebg-preview.svg';
